000000000000000000000
000000000000400000000
000000000000000000000
000000000000000000000
000000000000000000000
000000000000000000000
000000220000220000000
000002002002000200000
000020002200000002000
000200002200000020000
002000002200000200000
000200002200002000000
000020002200020000000
000000202202000000000
000333322222330033000
000000000000000000000
000000000000000000000
000000000000000000000
000000000000000000000
000000000100000000000
000000000000000000000