000000000000000000000
000000000000400000000
000000000000000000000
000000000000000000000
000000000000000000000
000000000000000000000
000000220000220000000
000002002002000200000
000020000000000002000
000200000000000020000
002000000000000200000
000200000000002000000
000020000000020000000
000000200002000000000
000333330033330033000
000000000000000000000
000000000000000000000
000000000000000000000
000000000000000000000
000000000100000000000
000000000000000000000